abrir -> [ abriu  ]
abriu -> [ abrir  ]
acaso -> [ ocaso aceso  ]
acesa -> [ aceso  ]
aceso -> [ acaso acesa  ]
adiar -> [ odiar aviar  ]
afora -> [ agora  ]
agora -> [ afora  ]
ainda -> [ linda finda  ]
alado -> [ arado amado  ]
amada -> [ amado  ]
amado -> [ alado arado amada  ]
ambas -> [ ambos  ]
ambos -> [ ambas  ]
amena -> [ ameno  ]
ameno -> [ amena  ]
amiga -> [ amigo  ]
amigo -> [ amiga  ]
anelo -> [ apelo anexo  ]
anexo -> [ anelo  ]
antro -> [ astro  ]
apego -> [ apelo  ]
apelo -> [ anelo apego  ]
arado -> [ brado prado irado alado amado  ]
arcar -> [ arfar  ]
ardil -> [ ardis  ]
ardis -> [ ardil  ]
areia -> [ ateia  ]
arfar -> [ arcar  ]
arroz -> [ atroz  ]
assar -> [ assaz  ]
assaz -> [ assar  ]
astro -> [ estro antro  ]
ateia -> [ areia  ]
atroz -> [ arroz  ]
atual -> [ atuar  ]
atuar -> [ atual  ]
autor -> [ tutor autos  ]
autos -> [ autor  ]
aviar -> [ adiar  ]
baixa -> [ caixa faixa baixo  ]
baixo -> [ baixa  ]
bando -> [ banzo banto  ]
banto -> [ tanto canto manto santo banzo bando  ]
banzo -> [ bando banto  ]
barro -> [ carro burro berro  ]
barão -> [ varão farão  ]
beata -> [ besta  ]
berro -> [ burro barro  ]
besta -> [ cesta sesta festa desta nesta beata  ]
bicho -> [ nicho bucho  ]
birra -> [ burra  ]
bolsa -> [ bolso  ]
bolso -> [ bolsa  ]
brabo -> [ brado bravo  ]
brado -> [ prado arado irado bravo brabo  ]
brava -> [ bravo  ]
bravo -> [ brado brabo brava  ]
brega -> [ briga  ]
briga -> [ brega brisa  ]
brisa -> [ briga  ]
bruma -> [ bruta  ]
bruta -> [ bruma bruto  ]
bruto -> [ fruto bruta  ]
bucho -> [ bicho  ]
burra -> [ birra burro  ]
burro -> [ berro barro burra  ]
cabal -> [ casal  ]
caber -> [ saber  ]
cacho -> [ facho macho cocho cacto  ]
cacto -> [ facto pacto casto canto cacho  ]
caixa -> [ faixa baixa  ]
calda -> [ cauda calma  ]
calma -> [ carma calda calmo  ]
calmo -> [ salmo calvo calma  ]
calor -> [ valor  ]
calvo -> [ salvo calmo  ]
campa -> [ campo  ]
campo -> [ campa  ]
canso -> [ manso censo canto  ]
canto -> [ tanto manto santo banto conto cinto casto cacto canso  ]
capaz -> [ rapaz  ]
cardo -> [ fardo pardo carro cargo  ]
cargo -> [ largo carro cardo  ]
carma -> [ calma carta  ]
carro -> [ barro cargo cardo  ]
carta -> [ farta certa casta carma  ]
casal -> [ cabal casar  ]
casar -> [ casal  ]
casta -> [ vasta cesta carta casto  ]
casto -> [ vasto custo canto cacto casta  ]
cauda -> [ calda causa  ]
causa -> [ cousa cauda  ]
caçar -> [ coçar  ]
ceita -> [ seita feita peita cesta certa  ]
cenho -> [ venho cunho censo  ]
censo -> [ senso denso tenso penso canso cenho  ]
cerca -> [ certa  ]
certa -> [ carta cesta ceita cerca certo  ]
certo -> [ perto certa  ]
cesta -> [ sesta festa besta desta nesta casta certa ceita  ]
cetro -> [ retro  ]
chaga -> [ chata chama  ]
chama -> [ chata chaga  ]
chata -> [ chama chaga chato  ]
chato -> [ chata  ]
cheia -> [ cheio  ]
cheio -> [ cheia  ]
chula -> [ chuva chulo  ]
chulo -> [ chula  ]
chuva -> [ chula  ]
cinto -> [ sinto conto canto  ]
cisão -> [ visão  ]
citar -> [ fitar  ]
civil -> [ covil  ]
claro -> [ clero  ]
clero -> [ claro  ]
cocho -> [ mocho cacho  ]
coesa -> [ coisa cousa coeso  ]
coeso -> [ corso coevo coesa  ]
coevo -> [ coeso  ]
coisa -> [ coesa cousa  ]
coito -> [ conto  ]
comer -> [ coser cozer cover  ]
conta -> [ monta conto  ]
conto -> [ ponto canto cinto coito conta  ]
coral -> [ moral corar  ]
corar -> [ morar coral  ]
corja -> [ coroa  ]
corno -> [ corpo corso  ]
coroa -> [ corja  ]
corpo -> [ corno corso  ]
corso -> [ dorso torso curso coeso corno corpo  ]
coser -> [ cozer comer cover  ]
cousa -> [ lousa causa coisa coesa  ]
cover -> [ mover coser cozer comer  ]
covil -> [ civil  ]
cozer -> [ coser comer cover  ]
coçar -> [ caçar  ]
crime -> [ prime crise  ]
crise -> [ crime  ]
culpa -> [ culta  ]
culta -> [ culpa culto  ]
culto -> [ vulto custo culta  ]
cunho -> [ cenho  ]
curso -> [ corso  ]
custo -> [ justo casto culto  ]
cível -> [ nível  ]
dengo -> [ denso  ]
densa -> [ dessa denso  ]
denso -> [ senso censo tenso penso dengo densa  ]
depor -> [ repor  ]
desde -> [ desse deste  ]
dessa -> [ nessa densa desta desse  ]
desse -> [ messe lesse nesse desde deste dessa  ]
desta -> [ cesta sesta festa besta nesta dessa deste  ]
deste -> [ peste teste neste desde desse desta  ]
deter -> [ reter dever  ]
detém -> [ retém  ]
dever -> [ rever deter devir  ]
devir -> [ dever  ]
digno -> [ signo  ]
dorso -> [ torso corso  ]
drama -> [ trama grama  ]
dúbia -> [ dúbio  ]
dúbio -> [ dúbia  ]
então -> [ estão  ]
ereto -> [ preto  ]
esgar -> [ estar  ]
estar -> [ esgar  ]
estio -> [ estro  ]
estro -> [ astro estio  ]
estão -> [ então  ]
facho -> [ cacho macho facto  ]
facto -> [ pacto cacto farto facho  ]
faina -> [ fauna faixa  ]
faixa -> [ caixa baixa faina  ]
falha -> [ valha folha falta  ]
falta -> [ malta farta falha  ]
fardo -> [ pardo cardo farto  ]
farsa -> [ farta  ]
farta -> [ carta falta farsa farto  ]
farto -> [ facto fardo farta  ]
farão -> [ varão barão  ]
fatal -> [ natal  ]
fator -> [ favor fatos  ]
fatos -> [ fator  ]
fauna -> [ faina  ]
favor -> [ pavor fator  ]
fazer -> [ lazer jazer fazes  ]
fazes -> [ fazer  ]
fazia -> [ jazia vazia  ]
feita -> [ seita peita ceita festa feito  ]
feito -> [ jeito leito peito feita  ]
feixe -> [ peixe  ]
fenda -> [ senda lenda renda finda  ]
festa -> [ cesta sesta besta desta nesta feita  ]
ficar -> [ fitar fixar  ]
final -> [ sinal  ]
finda -> [ ainda linda fenda findo  ]
findo -> [ lindo fundo finjo finda  ]
finjo -> [ findo  ]
firma -> [ forma firme  ]
firme -> [ firma  ]
fitar -> [ citar ficar fixar  ]
fixar -> [ ficar fitar  ]
fluir -> [ fruir  ]
foder -> [ poder  ]
folga -> [ folia folha  ]
folha -> [ falha folga folia  ]
folia -> [ folga folha  ]
fonte -> [ monte forte  ]
forma -> [ norma firma  ]
forro -> [ morro  ]
forte -> [ morte sorte porte fonte  ]
fossa -> [ possa nossa fosse fosso  ]
fosse -> [ posse fosso fossa  ]
fosso -> [ posso vosso nosso fosse fossa  ]
frota -> [ grota  ]
fruir -> [ fluir  ]
fruto -> [ bruto  ]
fugir -> [ fugiu  ]
fugiu -> [ fugir  ]
fundo -> [ mundo findo  ]
gemer -> [ temer  ]
genro -> [ tenro  ]
gente -> [ sente mente rente  ]
geral -> [ gerar  ]
gerar -> [ gerir geral  ]
gerir -> [ gerar  ]
gesto -> [ lesto resto gosto  ]
gosto -> [ posto mosto gesto  ]
grama -> [ trama drama grata  ]
grata -> [ grota grama grato  ]
grato -> [ trato grata  ]
grota -> [ frota grata  ]
haste -> [ hoste  ]
hoste -> [ haste  ]
humor -> [ rumor  ]
inata -> [ inato  ]
inato -> [ inata  ]
irado -> [ brado prado arado  ]
jazer -> [ fazer lazer  ]
jazia -> [ fazia vazia  ]
jeito -> [ leito feito peito  ]
jogar -> [ rogar  ]
junco -> [ junto  ]
junto -> [ justo junco  ]
justa -> [ justo  ]
justo -> [ custo junto justa  ]
labor -> [ sabor  ]
lapso -> [ lasso  ]
largo -> [ cargo  ]
lasso -> [ passo lapso  ]
lazer -> [ fazer jazer  ]
legal -> [ letal  ]
leigo -> [ meigo leito  ]
leite -> [ leito  ]
leito -> [ jeito feito peito lesto lento leigo leite  ]
lenda -> [ senda fenda renda linda  ]
lento -> [ tento vento leito lesto  ]
lesse -> [ desse messe nesse  ]
lesto -> [ gesto resto leito lento  ]
lesão -> [ tesão  ]
letal -> [ legal  ]
letra -> [ tetra  ]
lidar -> [ ligar  ]
ligar -> [ lugar lidar  ]
limbo -> [ limpo  ]
limpo -> [ limbo  ]
linda -> [ ainda finda lenda linha lindo  ]
lindo -> [ findo linda  ]
linha -> [ minha tinha vinha linda  ]
livre -> [ livro  ]
livro -> [ livre  ]
lição -> [ tição  ]
logro -> [ louro  ]
longe -> [ monge longo  ]
longo -> [ longe  ]
louca -> [ rouca lousa louco  ]
louco -> [ pouco louro louca  ]
louro -> [ logro louco  ]
lousa -> [ cousa louca  ]
lucro -> [ xucro  ]
lugar -> [ sugar ligar lutar  ]
lutar -> [ lugar  ]
lábia -> [ sábia  ]
macho -> [ facho cacho mocho macio macro  ]
macio -> [ macro macho  ]
macro -> [ macio macho  ]
magia -> [ mania magna  ]
magna -> [ magia  ]
malta -> [ falta  ]
manga -> [ manha mania  ]
manha -> [ minha manga mania  ]
mania -> [ magia manha manga  ]
manso -> [ canso manto  ]
manto -> [ tanto canto santo banto manso  ]
marca -> [ parca marco  ]
marco -> [ parco narco marca  ]
massa -> [ passa  ]
medir -> [ pedir  ]
meiga -> [ meigo  ]
meigo -> [ leigo meiga  ]
mente -> [ gente sente rente monte  ]
merda -> [ perda  ]
meses -> [ reses  ]
mesma -> [ mesmo  ]
mesmo -> [ mesma  ]
messe -> [ desse lesse nesse  ]
mimar -> [ minar  ]
mimos -> [ vimos  ]
minar -> [ mimar  ]
minha -> [ tinha vinha linha manha  ]
misto -> [ visto mosto  ]
mocho -> [ cocho macho molho  ]
molho -> [ mocho  ]
monge -> [ longe monte  ]
monta -> [ conta monte  ]
monte -> [ fonte mente morte monge monta  ]
moral -> [ coral morar  ]
morar -> [ corar moral  ]
morfo -> [ morro  ]
morro -> [ forro morfo  ]
morte -> [ forte sorte porte monte  ]
mosto -> [ posto gosto misto  ]
mover -> [ cover  ]
moção -> [ noção  ]
mundo -> [ fundo  ]
mútua -> [ mútuo  ]
mútuo -> [ mútua  ]
narco -> [ parco marco  ]
natal -> [ fatal  ]
nação -> [ noção  ]
negar -> [ pegar segar  ]
nessa -> [ dessa nossa nesta nesse  ]
nesse -> [ desse messe lesse neste nessa  ]
nesta -> [ cesta sesta festa besta desta nessa neste  ]
neste -> [ peste teste deste nesse nesta  ]
nicho -> [ bicho  ]
nobre -> [ sobre pobre  ]
norma -> [ forma  ]
nossa -> [ possa fossa nessa nosso  ]
nosso -> [ posso vosso fosso nossa  ]
noção -> [ moção nação  ]
nível -> [ cível  ]
ocaso -> [ acaso  ]
odiar -> [ adiar  ]
orgia -> [ urgia  ]
pacto -> [ facto cacto  ]
parca -> [ marca porca parva parco  ]
parco -> [ marco narco perco parvo pardo parca  ]
pardo -> [ fardo cardo parvo parco  ]
parte -> [ porte  ]
parva -> [ parca parvo  ]
parvo -> [ parco pardo parva  ]
pasma -> [ passa pasmo  ]
pasmo -> [ passo pasma  ]
passa -> [ massa possa pasma passo passe  ]
passe -> [ posse passo passa  ]
passo -> [ lasso posso pasmo passa passe  ]
pavor -> [ favor  ]
pedir -> [ medir  ]
pegar -> [ segar negar pesar  ]
peita -> [ seita feita ceita penta peito  ]
peito -> [ jeito leito feito perto peita  ]
peixe -> [ feixe  ]
penca -> [ penta  ]
penso -> [ senso censo denso tenso  ]
penta -> [ peita penca  ]
perco -> [ parco perto  ]
perda -> [ merda  ]
perto -> [ certo peito perco  ]
pesar -> [ pisar pegar  ]
peste -> [ teste deste neste  ]
pilar -> [ pisar  ]
pisar -> [ visar pesar pilar  ]
plaga -> [ praga  ]
plano -> [ pleno  ]
plena -> [ pleno  ]
pleno -> [ plano plena  ]
plumo -> [ prumo  ]
pobre -> [ nobre sobre  ]
podar -> [ pomar poder  ]
poder -> [ foder puder podar  ]
poema -> [ poeta  ]
poeta -> [ porta poema  ]
pomar -> [ tomar podar  ]
ponha -> [ punha  ]
ponto -> [ conto posto  ]
porca -> [ parca porra porta  ]
porra -> [ porta porca  ]
porta -> [ poeta porra porca porte  ]
porte -> [ forte morte sorte parte porta  ]
possa -> [ nossa fossa passa posse posso  ]
posse -> [ fosse passe posso possa  ]
posso -> [ vosso nosso fosso passo posto posse possa  ]
posto -> [ gosto mosto ponto posso  ]
pouco -> [ louco  ]
prado -> [ brado arado irado prazo  ]
praga -> [ traga plaga praia  ]
praia -> [ praga  ]
prazo -> [ prado  ]
presa -> [ prosa preso  ]
preso -> [ preto presa  ]
preto -> [ ereto proto preso  ]
prime -> [ crime  ]
probo -> [ prono proto  ]
prono -> [ probo proto  ]
prosa -> [ presa prova  ]
proto -> [ preto probo prono  ]
prova -> [ prosa  ]
prumo -> [ plumo  ]
puder -> [ poder pudor  ]
pudor -> [ puder  ]
pulha -> [ punha  ]
punha -> [ ponha pulha  ]
puído -> [ ruído  ]
pífia -> [ pífio  ]
pífio -> [ pífia  ]
rapaz -> [ capaz  ]
razão -> [ vazão  ]
recém -> [ retém refém  ]
redor -> [ repor  ]
refém -> [ retém recém  ]
reger -> [ reter rever reler  ]
reler -> [ reter rever reger reles  ]
reles -> [ reses reler  ]
renda -> [ senda lenda fenda  ]
rente -> [ gente sente mente  ]
repor -> [ depor redor  ]
reses -> [ meses reles  ]
resto -> [ gesto lesto  ]
reter -> [ deter rever reger reler  ]
retro -> [ cetro  ]
retém -> [ detém refém recém  ]
revel -> [ rever  ]
rever -> [ dever reter reger reler revel  ]
rigor -> [ vigor  ]
rogar -> [ jogar  ]
rouca -> [ louca roupa  ]
roupa -> [ rouca  ]
rumor -> [ humor  ]
ruído -> [ puído  ]
saber -> [ caber sabor  ]
sabor -> [ labor saber  ]
sadio -> [ vadio  ]
saldo -> [ soldo salvo salmo  ]
salmo -> [ calmo salvo saldo  ]
salva -> [ salvo salve  ]
salve -> [ salvo salva  ]
salvo -> [ calvo silvo saldo salmo salve salva  ]
santo -> [ tanto canto manto banto sinto  ]
segar -> [ pegar negar sugar selar  ]
seita -> [ feita peita ceita sesta sexta seiva  ]
seiva -> [ seita  ]
selar -> [ velar zelar segar  ]
senda -> [ lenda fenda renda sendo  ]
sendo -> [ vendo tendo senso senda  ]
senso -> [ censo denso tenso penso sonso sendo  ]
sente -> [ gente mente rente  ]
senão -> [ serão  ]
serão -> [ verão senão  ]
sesta -> [ cesta festa besta desta nesta seita sexta  ]
setor -> [ vetor  ]
sexta -> [ sesta seita sexto  ]
sexto -> [ texto sexta  ]
signo -> [ digno  ]
silvo -> [ salvo  ]
sinal -> [ final  ]
sinta -> [ sinto  ]
sinto -> [ cinto santo sinta  ]
sobre -> [ nobre pobre  ]
soldo -> [ saldo solto  ]
solta -> [ volta solto  ]
solto -> [ soldo solta  ]
sonho -> [ sonso  ]
sonsa -> [ sonso  ]
sonso -> [ senso sonho sonsa  ]
sorte -> [ forte morte porte  ]
subir -> [ sumir  ]
sugar -> [ lugar segar  ]
sumir -> [ subir  ]
super -> [ supor  ]
supor -> [ super  ]
sábia -> [ lábia sábio  ]
sábio -> [ sábia  ]
séria -> [ sério série  ]
série -> [ sério séria  ]
sério -> [ série séria  ]
símio -> [ sítio  ]
sítio -> [ símio  ]
tanto -> [ canto manto santo banto tento  ]
tecer -> [ temer  ]
temer -> [ gemer tecer temor  ]
temor -> [ temer  ]
tende -> [ tendo  ]
tendo -> [ sendo vendo tenro tenso tento tende  ]
tenha -> [ venha tinha tenra  ]
tenra -> [ terra tetra tenha tenro  ]
tenro -> [ genro tendo tenso tento tenra  ]
tenso -> [ senso censo denso penso tenro tendo tento  ]
tento -> [ vento lento tanto texto tenro tendo tenso  ]
termo -> [ terno  ]
terno -> [ termo  ]
terra -> [ tenra tetra  ]
teste -> [ peste deste neste  ]
tesão -> [ lesão  ]
tetra -> [ letra terra tenra  ]
texto -> [ sexto tento  ]
tinha -> [ minha vinha linha tenha  ]
tirar -> [ virar  ]
tiver -> [ viver  ]
tição -> [ lição  ]
tocar -> [ tomar  ]
todas -> [ todos  ]
todos -> [ todas  ]
tomar -> [ pomar tocar  ]
torso -> [ dorso corso  ]
traga -> [ praga trama trago  ]
trago -> [ trato traga  ]
trama -> [ drama grama traga  ]
trato -> [ grato trago  ]
traço -> [ troço  ]
troca -> [ troco  ]
troco -> [ troca  ]
troça -> [ troço  ]
troço -> [ traço troça  ]
tumba -> [ turba  ]
turba -> [ tumba turva turma  ]
turma -> [ turba turva  ]
turva -> [ turba turma turvo  ]
turvo -> [ turva  ]
tutor -> [ autor  ]
urdir -> [ urgir  ]
urgia -> [ orgia urgir  ]
urgir -> [ urdir urgia  ]
vadia -> [ valia vazia vadio  ]
vadio -> [ sadio vazio vadia  ]
valer -> [ valor  ]
valha -> [ falha velha valia  ]
valia -> [ vadia vazia valha  ]
valor -> [ calor valer  ]
varão -> [ farão barão virão verão vazão  ]
vasta -> [ casta vista vasto  ]
vasto -> [ casto visto vasta  ]
vazia -> [ jazia fazia valia vadia vazio  ]
vazio -> [ vadio vazia  ]
vazão -> [ razão varão  ]
vedar -> [ velar vetar  ]
velar -> [ selar zelar vetar vedar  ]
velha -> [ valha venha velho  ]
velho -> [ venho velha  ]
vemos -> [ vimos  ]
vendo -> [ sendo tendo vento venho  ]
venha -> [ tenha vinha velha venho  ]
venho -> [ cenho velho vendo vento venha  ]
vento -> [ tento lento vendo venho  ]
verba -> [ versa verbo  ]
verbo -> [ verso verba  ]
verde -> [ verve  ]
versa -> [ verba verso  ]
verso -> [ verbo versa  ]
verve -> [ verde  ]
verão -> [ serão varão virão  ]
vetar -> [ velar vedar vetor  ]
vetor -> [ setor vetar  ]
viger -> [ viver vigor  ]
vigia -> [ viria  ]
vigor -> [ rigor viger  ]
vilão -> [ visão virão  ]
vimos -> [ mimos vemos  ]
vinha -> [ minha tinha linha venha  ]
viram -> [ virar  ]
virar -> [ tirar visar viram  ]
viria -> [ vigia viril  ]
viril -> [ viria  ]
virão -> [ varão verão visão vilão  ]
visar -> [ pisar virar  ]
vista -> [ vasta visto  ]
visto -> [ misto vasto vista  ]
visão -> [ cisão vilão virão  ]
viver -> [ tiver viger  ]
volta -> [ solta  ]
vosso -> [ posso nosso fosso  ]
vulgo -> [ vulto  ]
vulto -> [ culto vulgo  ]
xucro -> [ lucro  ]
zelar -> [ selar velar  ]
árdua -> [ árduo  ]
árduo -> [ árdua  ]
árido -> [ ávido  ]
átimo -> [ ótimo átomo  ]
átomo -> [ átimo  ]
áurea -> [ áureo  ]
áureo -> [ áurea  ]
ávida -> [ ávido  ]
ávido -> [ árido ávida  ]
épico -> [ ético  ]
ética -> [ ótica ético  ]
ético -> [ épico ética  ]
ímpia -> [ ímpio  ]
ímpio -> [ ímpia  ]
órfão -> [ órgão  ]
órgão -> [ órfão  ]
ótica -> [ ética  ]
ótimo -> [ átimo  ]
única -> [ único  ]
único -> [ única  ]
609
